----------------X----------X----------
----------------X----------X----------
----------------X---------------------
----------------X----XX--------XXX----
----------------------X---------------
---XXXX---------------X---X-----------
-----X-----X--------------------------
-----------X-------------------XX----X
-------------------------------X------
----------------------XX-----XXX------
XXXX------------------X---------------
-----------XXX--------X---------------
-------------X------------------------
--------------------------------------
-----------------------------XXX---XXX
----XXXX---------------------------X--
--------------------------------------
--------------------------XXX---------
---------X-----------------------X----
---XXX---X---X-------------------X----
-----X-------X-------------------X----
-------------XX-----------X-----------
------------------X-----XXX-----------
------------------------X-------------
-------X--------------------------X---
-------X-------------X------------X---
