------------------X-------------------
------------------X-------------------
--------------------------------------
--------------------------------------
----XXX------------------------XXX----
--------------------------------------
--------------------------------------
-----------XXX----------XXX-----------
-----------X--------------X-----------
--------------------------------------
---XX----------------------------XX---
----X----------------------------X----
----X---XX------------------XX---X----
----X---XX------------------XX---X----
----X----------------------------X----
----X----------------------------X----
---XX----------------------------XX---
-----------X--------------X-----------
-----------XXX----------XXX-----------
--------------------------------------
--------------------------------------
--------------------------------------
----XXX------------------------XXX----
--------------------------------------
------------------X-------------------
------------------X-------------------
