--------------------------------------
--------------------------------------
--------------------------------------
------------------XX------------------
------------------XX------------------
------------------XX------------------
------------------XX------------------
--------------------------------------
--------------------------------------
--------------------------------------
---XX----------------------------XX---
----X----------------------------X----
----X---XXXX--------------XXXX---X----
----x---XXXX--------------XXXX---X----
----X----------------------------X----
----X----------------------------X----
---XX----------------------------XX---
--------------------------------------
--------------------------------------
------------------XX------------------
------------------XX------------------
------------------XX------------------
------------------XX------------------
--------------------------------------
--------------------------------------
--------------------------------------
